pretend	update	studio
associative	reference	{}
classic	form	()
primitive	scalar	<>
example	vector	||
signal	behaviour	__
distribute	club	""
span	consent	!!
enquiry	period	//
trouble	learn	\\
island	sense	&&
cache	slide	``
glyph	scroll	~~
drum	me	++
film	sector	==
echo	guest	--
event	full	%%
wall	attach	^^
fine	guarantee	::
fold	response	@@
job	line	лл
book	instruct	**
manage	quick	..
stock	wipe	;;
chat	room	??
opera	team	##
command	screen	,,
toss	deploy	marquee