_late_	_random_
_wakeUp28_	_except_
_cross_	_warning_
_fade_	_understand_
_exit_	_jobless_
_deprecate_	_reference_
_cute_	_empty_
_mic_	_leak_
_orange_	_transcript_
_cry_	_teach_
_highlight_	_mono_
_class_	_load_
_fate_	_key_
_forward_	_water_
_menthol_	_swap_
_summary_	_real_
_zero_	_fast_
_loss_	_bare_
_weak_	_near_
_sketch_	_order_
_lot_	_quite_
_bracket_	_fellow_
_easy_	_baby_
_ride_	_superstition_
_coincident_	_lour_
_war_	_dialogue_
_bubble_	_pain_
_attire_	_native_